WWWWWWWWWWWWWWWWWWWWW
WGGGGGGGGGGGGGGGGGGGW
WGGGGGGGGGGGGGGGGGGGW
WGGGGGGGGGGGGGGGGGGGW
WGGGGGGGWWWWGGGGGGGGW
WGGGGGGGWWWWGGGGGGGGW
WGGGGGGGWWWWGGGGGGGGW
WGGGGGGGGGGGGGGGGGGGW
WGGGGGGGGGGGGGGGGGGGW
WGGGGGGGGGGGGGGGGGGGW
WWWWWWWWWWWWWWWWWWWWW
